15
15
0 0 0 0 0 0 0 0 0 0 0 0 0 0 0
0 0 0 0 0 0 0 0 0 0 0 0 0 0 0
0 0 0 0 0 0 4 4 0 0 0 0 0 0 0
0 0 0 0 0 0 0 4 4 0 0 0 0 0 0
0 0 0 0 0 0 0 0 4 4 0 0 0 0 0
0 0 0 0 0 0 0 0 0 4 4 0 0 0 0
0 0 0 0 0 0 0 0 0 0 4 4 0 0 0
0 0 4 4 0 0 0 0 0 0 0 4 4 0 0
0 0 0 4 4 0 0 0 0 0 0 0 0 0 0
0 0 0 0 4 4 0 0 0 0 0 0 0 0 0
0 0 0 0 0 4 4 0 0 0 0 0 0 0 0
0 0 0 0 0 0 4 4 0 0 0 0 0 0 0
0 0 0 0 0 0 0 4 4 0 0 0 0 0 0
0 0 0 0 0 0 3 2 1 0 0 0 0 0 0
0 0 0 0 0 0 0 0 0 0 0 0 0 0 0